################
#..............#
#..##..##..##..#
#..##..##..##..#
#..##..##..##..#
#..##..##..##..#
#..##..##..##..#
#..##..##..##..#
#..##..##..##..#
#..##..##..##..#
#..............#
#..............#
#.##.##.##.##..#
#.C#.C#.C#.C#..#
#...........#..#
#GG##########GG#
